-----------------
-22123011233012--
---3210-23-121---
----12001-12311--
----0------323---
----0--321312----
----0---012312---
---001133211000--
-----------------