-----------------
----323-10-------
---3210-23-121---
----11330112311--
----0------323---
----0--321312----
----0---012312---
--3210112131011--
-----------------