-----------------
----323-10-------
--------23-121---
----0-212--0-----
----0------323---
----0----0-------
----0---012312---
----0---0-10-----
-----------------